...............
...............
...............
...............
...............
...A...o...B...
......www.p....
......wgwt.....
......www......
.....eeeee.....
...............
...............
...............
...p...........
...............
...............