wwwwwwwwwww
w........pw
w.A.......w
w...l.....w
w...wwwd..w
w...wgw...w
w..uwww...w
w.....r...w
w.......B.w
wp........w
wwwwwwwwwww