.............
.............
.............
...A...o...B.
......www.p..
......wgwt...
......www....
.............
.............
........e....
.............
...p.........