wwwwwwwwwwwww
w*...*...*..w
w*.w*....*.*w
w*.*.**..*..w
w..A...o...Bw
w..*..www.p.w
w.*...wgwt..w
w.*...www...w
w.*.w...**..w
w.*.**...**.w
w..*....e.w.w
w.*.....*...w
w..p.....*..w
wwwwwwwwwwwww