wwwwwwwwwwwww
w...*.*.*..pw
w...*.*.*...w
w..A..**....w
w....lu..*..w
w..*.www....w
w..*.wgw...*w
w..*.www....w
w.....dr....w
w...**.*.e..w
w...*.*..*..w
wp..*.......w
wwwwwwwwwwwww