wwwwww..wwwwwww
w.......*..*..w
w...*.....**..w
w*......p.....w
w..p......*...w
wp..*.......p.w
w..A.p........w
w.p...www.p...w
*.....wgw.....*
*.....www.....*
w....*........w
w.........*...w
w...*...*.....w
w.........**..w
w..p...*......w
w..........*..w
wwwwww..wwwwwww