...............
...............
...............
...............
...............
...A...........
......www.p....
......wgw......
......www......
...............
...............
...............
...............
...p...........
...............
...............