wwwwwwwwwwwww
w...*.*.*..pw
w$..*.$.*...w
w..A..**....w
w$...l...*$.w
w..*.wwwu...w
w..*.wgw....w
w..*dwww.e..w
w.$....r...$w
w...**.e.e..w
w...*.$..*.$w
wp..*.......w
wwwwwwwwwwwww