...............
...............
...............
....o..........
...............
...A...........
......www.p....
......wgw......
......www......
...............
...p.......o...
...............
...............