...............
...............
...............
...............
.......A.......
t..............
......www.p....
......wgw......
......www......
t....o...o.....
...............
...............
...............
...p...........
...............
...............