wwwwwwwwwwwwwwwwwwwwwwwwwwwwwww
w......w....w....w....w.......w
w......w..u.w....w$.u.w.......w
w......w$..$w....w....www.....w
w..Ap..w..p.w$.p.w..p.wgw.....w
w......w....w....w....www.....w
w......w$..$w....w....w.......w
w...d..w....w..d.w$...w.......w
w......w....w....w....w.......w
wwwwwwwwwwwwwwwwwwwwwwwwwwwwwww