wwwwwwwwwwwwwwwwwwwwwwwwwww
w.....w.....w.....w.....w.w
w.....w..u..t.....w$.u..t.w
w.....w$...$t.....t.....www
w..Ap.t..p..t$.p..w..p...gw
w.....t.....t.....t.....www
w..d..t$...$t..d..t.....w.w
w.....w.....w.....t$....t.w
wwwwwwwwwwwwwwwwwwwwwwwwwww
