wwwwwwwwwwwwwwwwwwwwwww
r.....................l
w.....p$w$$$$$w$p.....w
w.....$ww$$p$$ww$.....w
w.....$ww$$$$$ww$..w..w
wp.A..$ww$$p$$ww$.wgw.w
w.....$ww$$$$$ww$..w..w
w.....$ww$$p$$ww$.....w
w.....p$w$$$$$w$p.....w
r.....................l
wwwwwwwwwwwwwwwwwwwwwww