wwwwwwwwwwwww
w...*.*.*..pw
w$..*.$.*...w
w..A..**....w
w$...lu..*$.w
w..*.wcw....w
w..*.cgc....w
w..*.wcw....w
w.$...dr...$w
w...**.*.e..w
w...*.$..*.$w
wp..*.......w
wwwwwwwwwwwww