wwwwwwwwwwwwwwwwwwwwwwwwwwwwwww
w......w....w....w....w.......w
w......w..u.w....w$.u.t.......w
w......w$..$w.........www.....w
w..Ap..t..p.w$.p.w..p..gw.....w
w................w....www.....w
w......w$..$t....t....w.......w
w..d...w....w..d.w$...t.......w
w......w....w....w....w.......w
wwwwwwwwwwwwwwwwwwwwwwwwwwwwwww
