wwwwwwwwwwwwwwwwwwwwwww
w...........w.........w
w....r......w....$$...w
w...........w......w..w
w...........w.....w$w.w
w..A....p...w..p.w$g$ww
w...........w.....w$w.w
w...........w......w..w
w...$$......w.....l...w
w...........w........pw
wwwwwwwwwwwwwwwwwwwwwww
